SO ./path_to_the_south_texture
NO ./path_to_the_north_texture
WE ./path_to_the_west_texture
EA ./path_to_the_east_texture

S ./path_to_the_sprite_texture
R 1920 1080
F 130,130,130
C 255,107,200

111111    11111111
100001111110000001
100000020000000001
1N0001111110000001
111111    11111111
